src_app,target_app,src_index,target_index
a0,a1,2,4
a0,a1,3,6
a0,a1,4,8
a0,a1,5,7
a0,a1,9,9
a1,a0,4,2
a1,a0,6,3
a1,a0,8,4
a1,a0,7,5
a1,a0,9,9
a0,a3,3,7
a0,a3,5,8
a0,a3,17,12
a3,a0,7,3
a3,a0,8,5
a3,a0,12,17
a1,a3,0,4
a1,a3,5,6
a1,a3,6,7
a1,a3,7,8
a3,a1,4,0
a3,a1,6,5
a3,a1,7,6
a3,a1,8,7
a2,a4,1,0
a2,a4,2,2
a4,a2,0,1
a4,a2,2,2
